~~~~~r~~~r~~
~...r~~~~~r~
~...~~.t.~~~
~.r#~~~~~~r~
~...r~~~~r~~
~rrrr~~~~~~~
~.s.r~~~~~~~
~...r~~~~r~~
~~.~#~~~~~r~
~.rrrrrrr~~~
~...~~~~~~r~
~~~~~~~~~r~~
