001111111111
001111111111
001111111111
001111111111
001111111111
000011111111
000011111111
000111111111
