111111111111
110000110001
100001111001
100000110001
100001111101
100000110001
110000110001
111111111111
