000000000000000000000000000
011100000000000000000000000
012110011000000000000333450
011110121100000000000221110
001100011000000000000000000
000011100000000000000001120
000122100000000000000001110
000111000000000000000000010
000010000000000000000000000
000000000000000000000000000
