000000000000000000000000000
011100000000000000000000000
011110022000000000000555550
011110222200000000000555550
001100022000000000000000000
000033300000000000000004440
000333300000000000000004440
000333000000000000000000040
000030000000000000000000000
000000000000000000000000000
