111111111111111111111111111
100011111111111111111111111
100001100111111111111000001
100001000011111111111000001
110011100111111111111111111
111100011111111111111110001
111000011111111111111110001
111000111111111111111111101
111101111111111111111111111
111111111111111111111111111
