~~~~~~~~~~~~~~~~
~~~~~~~~3....~~~
~~~~~~~~......~~
~~~~~~~.....r.~~
~~~~~~~.t.....~~
~~~5...~.....~~~
~~~.tp.~~~.p~~~~
~~~....~~~~~~~~~
~~~~~~~~~~~..~~~
~~~~~.~~~2....~~
~~~4....r.r...~~
~~.t....r...t.~~
~~.....tp~.p.~~~
~~~~....~|~~~~~~
~~~~~|~~~|1..~~~
~~~~~|~~~|r....~
~6..~##~~...pt.~
~.s.p~#~~..r...~
~...~~~~~~~~~~~~
~~~~~~~~~~~~~~~~
