111111111111
100010001000
111111111111
111111111111
100010001000
111111111111
111111111111
100110011001
111111111111
111111111111
100110111001
111111111111
