000000000000
011101110111
000000000000
000000000000
011101110111
000000000000
000000000000
013001400110
000000000000
000000000000
011001000110
000000000000
