000000000000
011102220333
000000000000
000000000000
044405550666
000000000000
000000000000
0770088009a0
000000000000
000000000000
0bc00d000ff0
000000000000
