000000000000
044411111100
030000000010
021100001110
000000011110
011100001111
011110001111
000000000000
