000000000000
011111111000
011000000020
011100002220
000000022220
033000002220
033330002220
000000000000
