111111111111
100000000011
101111111101
100011110001
111111100001
100011110000
100001110000
111111111111
