000001000100
000010000010
000000000000
001000000010
000010000100
011110000000
000010000000
000010000100
000000000010
001111111000
000000000010
000000000100
