000000000000
011100000000
011100000000
011000000000
011100000000
000000000000
000000000000
000000000000
000000000000
000000000000
000000000000
000000000000
