111111111111
100011111111
100011000111
100111111111
100001111111
100001111111
100001111111
100001111111
110111111111
100001111111
100011111111
111111111111
