000000000000
000000000100
001000000100
000000000000
000000000000
000100000001
000000000001
000000000000
