000000000000
003333002220
033330000220
033133002220
011110000020
011111002220
001111002220
000000000000
