000000000000
001111001110
011110000110
011011001110
000000000000
000000000000
000000000000
000000000000
