0000000000000000
0000000088000000
0000000088765400
0000000111111300
0000000121111200
0003211011111000
0002211000110000
0001111000000000
0000000000011000
0000010001111100
0001111111111100
0012111111112100
0011111210111000
0000111100000000
0000000000111000
0000000000111110
0111000001111210
0111100001111110
0111000000000000
0000000000000000
