0000000000000000
0000000033333000
0000000033333300
0000000333333300
0000000333333300
0005555033333000
0005555000330000
0005555000000000
0000000000022000
0000040002222200
0004444402222200
0044444402222200
0044444440222000
0000444400000000
0000000000111000
0000000000111110
0666000001111110
0666600001111110
0666000000000000
0000000000000000
