1111111111111111
1111111100000111
1111111100000011
1111111000000011
1111111000000011
1110000100000111
1110000111001111
1110000111111111
1111111111100111
1111101110000011
1110000000000011
1100000000000011
1100000001000111
1111000011111111
1111111111000111
1111111111000001
1000111110000001
1000011110000001
1000111111111111
1111111111111111
