000000000000
011111022200
011111022200
011100000000
011111100000
011111100000
011111100000
000000000000
