011000000000
111111111110
111111111110
333322212330
333212311330
111111111110
111100001110
133133113310
222211111110
