011000000000
222222222220
333333333330
444444444440
555555555550
666666666660
777777777770
888888888880
999999999990
