100111111111
000000000001
000000000001
000000000001
000000000001
000000000001
000011110001
000000000001
000000000001
