~~~~~~~~~~~~
~~~^^^^^^^^~
~~^^^^^^.=^~
~^^^---2...~
~^43.1.....~
~.......pr~~
~~~~.....~~~
~~~~~~~~~~~~
