188000000088
100000011111
111111155500
111111100000
111101100000
100100000000
101111100000
111111111000
111111111000
111333111333
111111111111
