000111111100
011111100000
000000000011
000000011111
000000011111
011011111111
010000011111
000000000111
000000000111
000000000000
000000000000
