000000000000
000000000000
034111111110
020000000000
011111111110
011111111110
000000000000
000000000000
