000000000000
000000000000
011111111110
010000000000
022222222220
033333333330
000000000000
000000000000
