000000000000
034511032300
022211012200
022200000000
022223200000
011132300000
011123200000
000000000000
