110000000000
110000000000
110000000000
110000000000
110000000000
221100000000
221100000000
331000000000
