000000000000
000000000000
000001011100
000000000000
000001100000
000000100000
011100000000
000000000000
