111111111111
100000100011
100000101011
100011111111
100000011111
100000011111
100000011111
111111111111
