110010010000
100000000000
100000000000
100000000000
110000011111
110000011111
111000000111
100000100000
100000000000
