0000000000000000000000000000000000000000000000000000000
0000000000000000000000000000000000000000000000000000000
0000000000000000000000000001110000000000000001111000000
0000000000000000000001110001110000000000000002111000000
0000000000000000111011111001110000000011000000000000000
0000000000000000112012111001000000001111000111000000000
0000000000011100111011111000000000102111011121000000000
0000000000012101111011111011110000100000011111000000000
0000000000011101111011110012111000210000011100000000000
0000000000011101121000000011111011111000000000000000000
0000000000111100000000012011111011111000000000000000000
0000000000110000011110011000000000000000000000000000000
0000000000000000012111000000000000011100000000000000000
0000000011100000011111110000000000012100000000000000000
0000000011100000001111110000000000011111101100000000000
0000000011111000001110000000000000001111001110000000000
0000000001121000000000000000000000000121000110000000000
0000000001111000000000000000000000000011000110000000000
0000000000000001110000000000000000000000000200000000000
0000000000111111110000000000000111001121000000000000000
0000000000121111110000000000000221101111110100000000000
0000000000111111110000000001110111001121001210000000000
0000000000000000000000000011210101000111001110000000000
0001110001111000000000000011110000000000001110000000000
0011112011211000000000000011210000000000000000000000000
0001110001111000000000000000001111100000000000000000000
0000000000000000000000000000001221101110111111100000000
0000000000000000000000000000001110001112001111200000000
0000000000000000000000000000000000121111001211100000000
0000000000000000000000000000000000111111001111120111011
0000000000000000000000000000000000111111001111110112011
0000000000000000000000000000000000000000001112110111011
0000000000000000000000000000000000000000000111100000000
0000000000000000000000000000000000000000000000000000000
0000000000000000000000000000000000000000000000000000000
