1111111111111111111111111111111111111111111111111111111
1111111111111111111111111111111111111111111111111111111
1111111111111111111111111110001111111111111110000111111
1111111111111111111110001110001111111111111110000111111
1111111111111111000100000110001111111100111111111111111
1111111111111111000100000110111111110000111000111111111
1111111111100011000100000111111111010000100000111111111
1111111111100010000100000100001111011111100000111111111
1111111111100010000100001100000111001111100011111111111
1111111111100010000111111100000100000111111111111111111
1111111111000011111111100100000100000111111111111111111
1111111111001111100001100111111111111111111111111111111
1111111111111111100000111111111111100011111111111111111
1111111100011111100000001111111111100011111111111111111
1111111100011111110000001111111111100000010011111111111
1111111100000111110001111111111111110000110001111111111
1111111110000111111111111111111111111000111001111111111
1111111110000111111111111111111111111100111001111111111
1111111111111110001111111111111111111111111011111111111
1111111111000000001111111111111000110000111111111111111
1111111111000000001111111111111000010000001011111111111
1111111111000000001111111110001000110000110001111111111
1111111111111111111111111100001010111000110001111111111
1110001110000111111111111100001111111111110001111111111
1100000100000111111111111100001111111111111111111111111
1110001110000111111111111111110000011111111111111111111
1111111111111111111111111111110000010001000000011111111
1111111111111111111111111111110001110000110000011111111
1111111111111111111111111111111111000000110000011111111
1111111111111111111111111111111111000000110000001000100
1111111111111111111111111111111111000000110000001000100
1111111111111111111111111111111111111111110000001000100
1111111111111111111111111111111111111111111000011111111
1111111111111111111111111111111111111111111111111111111
1111111111111111111111111111111111111111111111111111111
