000000000000
011100000000
011100121000
011000000000
011110000000
011110000000
011110000000
011110000000
001000000000
011110000000
011100000000
000000000000
