001101101111
011111111111
011111111111
011111111111
001111100000
001111100000
000111111000
011111011111
