000000000000
010000000001
010000000001
010000000001
000000000001
000000010001
000000000001
000000000000
