111111111111
111111111111
100000000001
101111111111
100000000001
100000000001
111111111111
111111111111
