000000000000
000000000000
011000000110
010000000000
000000000110
000000000110
000000000000
000000000000
