~~~~~~~~~~~~~~~~~~~~~~~~~~~
~1..~~~~~~~~~~~~~~~~~~~~~~~
~pt..~~2.~~~~~~~~~~~~5....~
~....~pt..~~~~~~~~~~~...p.~
~~.R~~~..~~~~~~~~~~~~~~~~~~
~~~~p3.~~~~~~~~~~~~~~~~4pt~
~~~.tt.~~~~~~~~~~~~~~~~...~
~~~..R~~~~~~~~~~~~~~~~~~~R~
~~~~.~~~~~~~~~~~~~~~~~~~~~~
~~~~~~~~~~~~~~~~~~~~~~~~~~~
