000000000000
000111111110
001111111110
011111111110
011111111110
011111111110
000011111100
000000000000
