000000000000
000111111110
001111110110
011111110000
010000000000
000000000000
000000000000
000000000000
