000000000000
000555555550
005555551550
055533331110
051111111110
011111111110
000011111100
000000000000
