111111111111
111000000001
110000000001
100000000001
100000000001
100000000001
111100000011
111111111111
